map1
#################
# --            #
# --#    # X    #
#   #   #       #
#   #  ####HH####
#   H     -     #
#   #  #  -     #
# O #   #   -   #
##-##   #       #
#   #  --  #    #
#   #  --  #    #
#   H  --  #    #
#   #  --  #  X #
#   #  --  #    #
#   #      #    #
#      X        #
#################
