map2
###########################
#                         #
#   #    #                #
# X #   #                 #
#   #  ####HH####    ##HH##
#   H     -   #   -- #    #
#   #  #  -   H  --  #    #
#   #   #   - # -    ##HH##
#---#   # X   #           #
#       ----- #           #
#             #           #
#             -           #
#  O          #      X    #
#             #           #
###########################
