map3
###############
# --          #
# --#    # X  #
#   #   #     #
#   #  ####HH##
#   H     -   #
#   #  #  -   #
# O #   #   - #
#####   #     #
#             #
#             #
#             #
#             #
#   X      X  #
###############
