map4
#######################
# --                  #
# ---                 #
#   ---         #     #
#      ####HH###  X   #
#        -     #      #
#  X   #  - X  -      #
#       #      #      #
#####   #    ###   ---#
#    #            ----#
# O              -----#
#######################
