map5
###########################
#  ------                 #
#     --X--               #
#---    ----              #
#--     ####   ####       #
#-     #           #      #
# -       ---       #     #
# -  #    --      -- #    #
#----H    -   O  -   -    #
#    #   --    --    #    #
#             ---   #  X  #
#      #           #      #
# X     ####---####       #
#                         #
###########################
